0000000000000000000000000000000000000000000000000000000000000000
0000000000000000000000000000000000000000000000000000000000000000
0000000000000000000000000000000000000000000000000000000000000000
0000000000000000000000000000000000000000000000000000000000000000
0000033333330000000000000000000000000000000000000000000000000000
0000030000000000000000000000000000000000000000000000000000000000
0000030000000000000000000000000000000000000000000000000000000000
0000030000000000000000000000000000000000000000000000000000000000
0000030000000000000000000000000000000000000000000000000000000000
000003h00000000000000000000000000000000000000000000000000000000b
000003333333003333003000300000003333333330000033300000000000000b
000000000000000000000000000000000000000000000000000000000000000b
c00000000000000000000000000000000000000000000000000000000000000b
c00000000000000000000000000000000000000000000000000000000000000b
c000000000000000000000000000000000000000000f0000000000000000000b
c00000000000000000000000000000000000000000110000000000000000000b
cpgg0g000g00000000gggfg000g00g000011111111221111000000ggggggg0pb
1111111111000000001111111111111111222222222222221100011111111111
2222222222100000112222222222222222222222222222222200022222222222
3333333333000002222222222222222222222222222222222220000222222222
333333000000002222222222222222222222222222222222222200f000022222
0000000000003332222222222222222222222222222222222222222000002222
0000000000033222222222222222222222222222222222222222222220002222
p0000000003322222222222222222222222222222222222222222222dp002222
333333333332222222222222222222222222222222222222222222222dd22222