0000000000000000000000000000000000000000000000000000000000000001
0000000000000000000000000000000000000000000000000000000000000002
0000000000000000000000000000000000000000000000000000000000000002
00000000000000000000000000000000000000000000000000000000f00000l2
0000000000000000000000000000000000000000000000000000011111111112
00000000000000000000000000000000000000000gggggg00000000000000000
0000000000000000000000000000000000000000111111111110000000000000
0000000000000000000000000000000000000000000000000000000000000000
e000000000000000000000000000111111111000000000000000000000000000
e00000000000000000000000000000000000000000000000000000000000000a
e00000000000000000000g00g0g000000000000000000000000000000000000a
e00000000000000000000111111000000000000000000000000000000000000a
110000000000000000000000000000000000000000000000000000000000000a
220000000000000000000000000000111110000000f00g00f00000000000000a
220000000000000000000000000000000000000001111111110000000000000a
2200000000000000000000000000000000000gg012222222220000000g0000pa
2200000g000000000f000gfg0000000000011111222222222211111111111111
2111111111112111111111111111111111122222222222222222222222222222
2222222222222222222222222222222222222222222222222222222222222222
2222222222222222222222222222222222222222222222222222222222222222
2222222222222222222222222222222222222222222222222222222222222222
2222222222222222222222222222222222222222222222222222222222222222
2222222222222222222222222222222222222222222222222222222222222222
2222222222222222222222222222222222222222222222222222222222222222
2222222222222222222222222222222222222222222222222222222222222222