4444444444444444444444444444444444444444444444444444444444444444
4777777777777777777777777777777777777777777777777777777777777774
4000000000000000000000000000077777777777777777777777777777777774
4000000000000000000000000000070000000000000000000000700000000004
4000000000000000000000000000070000000000000000000000700000000004
4000000000000000000000000000070000000000000000000000700000000004
6000000000000000000000000000070000000000000000000000700000000004
6000000000000000000000000000070000000000000000000000700000000006
6000000000000000000000000000070000000000000000000000700000000006
6000000000000000000000000000070000000000000000000000700000000006
6000000000000000000000000000070000000000000000000000700000000006
6777777770000000000000000000000000000000000000000000000000000006
6070000700000000000000000000000000000000000000000000000000000006
4070000700000000000000000000000000000000000000000000000000000004
407000070rkk000000ss0000s000000000000000000paa000000000000000004
4888888888888888888888888888878888888888888888888888788888888884
4777777777777777777777777777777777777777777777777777777777777774
4444444444444444444444444444444444444444444444444444444444444444
4444444444444444444444444444444444444444444444444444444444444444
4444444444444444444444444444444444444444444444444444444444444444
4444444444444444444444444444444444444444444444444444444444444444
4444444444444444444444444444444444444444444444444444444444444444
4444444444444444444444444444444444444444444444444444444444444444
4444444444444444444444444444444444444444444444444444444444444444
4444444444444444444444444444444444444444444444444444444444444444

