4444444444444444444444444444444444400000004000000000000000000004
4444444444444444444444444444444444400000004000000000000000n00004
4444444444444444444444444444444444600000006000000000004444444444
4444444444444444444444444444444444600000006000000000000000000004
4444444444444444444444444444444444600000006000000000000000000004
4444444444444444444444444444444444600000006000000000600000000004
4444444444444444444444444444444444400000004000000000600000000000
444444444444444444444444444444444440000000400000000044000000000p
4444444444444444444444444444444444444444444000000000444444400444
4444444444444444444444444444444444400000004000000000400000000004
4777777777777777777777777777777777400000006000000000600000000004
4777777777770000000000000000000000400000006000000000600000000004
4777777777770000000000000000000000400000006000000000600000000007
47777777777700000000000000000000006000000060000000006n0000000004
4777777777770000000000000000000000600000000000000000488888800884
4777777777770000000000000000000000600000000000000000044444400444
4777777777770000000000000000000000600000000000000000000000000004
47777777777b0000000000000000000000000000004000000000000000000007
47777777777bp0r000ss000000ss0000000000000040000000004tvttt00nvt7
4888888888888888888888888888888888444444444000000000444444444447
4444444444444444444444444444444444400000000000000000000000000004
4444444444444444444444444444444444400000000000000000000000000004
4444444444444444444444444444444444400000000000000000000000000004
44444444444444444444444444444444444ssssssssssssssssssssssssssss4
4444444444444444444444444444444444411111111111111111111111111114

