22222222222222222222222222222222222222222222222222222222
33333333333333333333333333333333333333333333333333333333
33333333333333333333333333333333333333333333333333333333
33333333333333333333333333333333333333333333333333333333
33333333333333333333333333333333333333333333333333333333
33333333333333333333333333333333333333333333333333333333
33333333333333333333333333333333333333333333333333333333
3ii0ii00000i000i0000000000000000000000pc000000000000000c
30l00000000000000003333333333333333333333333333333333333
33333000000000000005333333333333333333333333333333333333
3--00000000000000005333333333333333333333333333333333333
3l0s0000000000000335333333333333333333333333333333333333
33333333300000000333333333333333333333333333333333333333
a0000000330000000353333333333333333333333333333333333333
a0000000000330000533333333333333333333333333333333333333
a0000000000330000553333333333333333333333333333333333333
ap000000000330sss553333333333333333333333333333333333333
33333333333333333333333333333333333333333333333333333333
33333333333333333333333333333333333333333333333333333333
33333333333333333333333333333333333333333333333333333333
33333333333333333333333333333333333333333333333333333333
33333333333333333333333333333333333333333333333333333333
33333333333333333333333333333333333333333333333333333333
33333333333333333333333333333333333333333333333333333333
