222222222222222222222222222222222222222222222222222222222222
333333333333333333333333333333333333333333333333333333333333
333333333333333333333333333333333333333333333333333333333333
333333333333333333333333333333333333333333333333333333333333
333333333333333333333333333333333333333333333333333333333333
333333333333333333333333333333333333333333333333333333333333
333333333333333333333333333333333333333333333333333333333333
333333333333333333333333333333333333333333333333333333333333
3eiiii000000000i00000000000000000000000000000000000b0000000b
300000000000000000000000000000000000000000000000000b0000000b
300000000000000000000000000000000000000000000000000b0000000b
30000000000000000000000000000000000000000000000000pb0000000b
300000000000000000000333333336333333333333333333333333333333
300000000000000005500000333333333333333333333333333333333333
300000000000055003500000333333333333333333333333333333333333
300000000000053005300000336663333333333333333333333333333333
300000000000355005500000333333333333333333333333333333333333
3p000hhh0050000000000000333333333333333333333333333333333333
333333333333333333333333333333333333333333333333333333333333
333333333333333333333333333333333333333333333333333333333333
333333333333333333333333333333333333333333333333333333333333
333333333333333333333333333333333333333333333333333333333333
333333333333333333333333333333333333333333333333333333333333
333333333333333333333333333333333333333333333333333333333333
333333333333333333333333333333333333333333333333333333333333