4444444444444444444444444444444444444444444444444444444444444444
4000000000000000000000000000000000000000000000000000000000000004
e000000000000000000000000000000000000000000000000000000000000004
e000h00000000000000000000000000000000000000000000000000000000004
4333333333333330000000000000000000000000000000000000000000000004
4000000000000000030000000000000000000000000000000000000000000004
4000000000000000000000000000000000000000000000000000000000000004
4000000000000000000000000000000000000000000000000000000000000004
4000000000000000000000000003333333000000000000000000000000000004
4000000000000000000000000000000000000000000000000000000000d00004
400000000000000000000000000000000000000000000000000000000pd00004
4000000000000000000000000000000000000000333333333333333333333334
4000000000000000000000000000000000033000000000000000000000000004
4000000000000000000000000000000330000000000000000000000000000004
4000000000000000000000000000330000000000000000000000000000000004
4000000h00000000000000000000000000000000000000000000000000000004
4333333333333333333333333330000000000000000000000000000000000004
4333333333333333333333333333330000000000000000000000000000000004
4333333333333333333333333333333330000000000000000000000000000004
4333333333333333333333333333333333330000000000000000000000000004
4333333333333333333333333333333333333330000000000000000000000004
433333333333333333333333333333333333333330000000000000000000000a
43333333333333333333333333333333333333333300000000000000000000pa
333333333333333333333333333333333333333330cp03333333333333333333
33333333333333333333333333333333333333300ccc33333333333333333333