4444440000000000000000000000000000000000000000000000000000000000
4444440000000000000000000000000000000000000000000000000000000000
4466640000000000000000000000000000000000000000000000000000000000
4466640000000000000000000000000000000000000000000000000000000000
4466640000000000000000000000000000000000000000000000000000000000
4444440000000000000000000000000000000000000000000000000000000000
4444440000000000000000000000000000000000000000000000000000000000
4466640000000000000000000000000000000000000000000000000000000000
4466640000000000000000000000000000000000000000000000000000000000
446664000000h00000000000000000000000000000000000000000000000000p
4444440000011110000000000000000000000000000000000000000000000111
44444400000000000000h0000000000000000000000000000000000000011222
4444440000000000000111111000000000000000000000000000000111122222
444444000000000000000000000001111110000000f00g00f000111222222222
4444440000000000000000000000000000000000011111111111222222222222
44444b0000000000000000000000000000000gg0122222222222222222222222
33333bp00000g0gg0f000gfg0000000gggg11111222222222222222222222222
2111111111112111111111111111111111122222222222222222222222222222
2222222222222222222222222222222222222222222222222222222222222222
2222222222222222222222222222222222222222222222222222222222222222
2222222222222222222222222222222222222222222222222222222222222222
2222222222222222222222222222222222222222222222222222222222222222
2222222222222222222222222222222222222222222222222222222222222222
2222222222222222222222222222222222222222222222222222222222222222
2222222222222222222222222222222222222222222222222222222222222222