1000000000000000000000000000000000000000000000000000000000000001
2000000000000000000000000000000000000000000000000000000000000002
2000000000000000000000000000000000000000000000000000000000000002
2000000000000000000000000000000000000000000000000000000000000002
20n0s0000000001ssss000000000000000000000000000000000000000000002
211111111111112111111111100000000000000000000000000000000000fff2
0000000000000000000000000110000000000000000000000000000001111111
0000000000000000000000000001000000000000000000000000000012222222
0000000000000000000000000002000000000000000000000000011122222222
0000000000000000000000000000100000000000000000000000022222222222
a000000000000000000000000000011111110000001111100000g22222222222
a000000000000000000000000000000000000000000000000000122222222222
a000000000000000000000000000000000000000000000000000222222222222
a000000000000000000000000000000000000000000000000000222222222222
a000000000000000000000000000000000000000000000000000222222222222
a000000000000000000000000000000000000gg0000000000111222222222222
ap00000g00000f000f000ggg0000000000011111111111112222222222222222
1111111111111111111111111111111111122222222222222222222222222222
2222222222222222222222222222222222222222222222222222222222222222
2222222222222222222222222222222222222222222222222222222222222222
2222222222222222222222222222222222222222222222222222222222222222
2222222222222222222222222222222222222222222222222222222222222222
2222222222222222222222222222222222222222222222222222222222222222
2222222222222222222222222222222222222222222222222222222222222222
2222222222222222222222222222222222222222222222222222222222222222