333333333333333333333333333333333333333333333333333333333aa33333
3i000000ii00000000i3iiii00030000000000000000000000000000000p0003
30000000000000000o0300000003000000000000000000000000000000000003
5000000000000000l0t300000003000000000000000000000033553335553333
50000000003333333333000000030000000000000000000333000000000000i3
3000000000000000003300000003333333333000033300000000000000000vt3
5tl000vv00000000003000000000000000003000000300000000000000000333
33333333330000000030000000000000000033300003000000000000000000i3
3i000000000000000v30000000000000000030000003300000000000000000t3
3000000000000000t33000000000000000003000033300000000000000000333
3000000333333333330000000000000000003000003000000000000000000003
30000000000000000000000000000000000030000030000000000000000vt0v3
5000000000000000000000000000000000003330003333300000000000033333
3333300000000000000000000000000000000000003000000000000000000ii3
5000000000000000000000000000000000000000003000000000000000000003
3000000000000000000000000000000000000000033000l000000000t000v0t3
3v00000v00000000000000tv0000000000000000t33555555555555ss5555555
55555555555555555555555555555ssssss33333333333333333333333333333
3333333333333333333333333333333333333333333333333333333333333333
3333333333333333333333333333333333333333333333333333333333333333
3333333333333333333333333333333333333333333333333333333333333333
3333333333333333333333333333333333333333333333333333333333333333
3333333333333333333333333333333333333333333333333333333333333333
3333333333333333333333333333333333333333333333333333333333333333
3333333333333333333333333333333333333333333333333333333333333333