3333333333333333333333333333333333333333333333333bbbb33333333333
300000000000000000000000000000000000000000000000000p000000000003
3000000000000000000000000000000000000000000000000000000000000003
3000000000000000000000000000000000000000000000000000000000000tv3
3000000000000000000000000000000000000000000000000033333333333333
3000000000000000000000000000000000000000000000000330h0h000000003
3000000000000000000000000000000000003333333333333333333300000ht3
30000000000000033300003000003330000000003th0h0000000000000000333
3000000000000000000000000000000000000000333330000000000000000003
300000003000000000000000000000000000000030h0000000000000000hh0t3
3300000000000000000000000000000000000000333300000000000033333333
3300000000000000000000000000000000000000300000000000000000000003
33000000000000000000000000000000000000000000000000000000000000t3
33n0000000000000000000000000000000000000000000000000000000000333
3333333000000033000000333300000000000000333333333300000000000003
33000000000000000000000000000000300000033333333333000l00000000v3
33sssssssssssssssssssssssssssssssssssss3333333333333333333333333
3333333333333333333333333333333333333333333333333333333333333333
3333333333333333333333333333333333333333333333333333333333333333
3333333333333333333333333333333333333333333333333333333333333333
3333333333333333333333333333333333333333333333333333333333333333
3333333333333333333333333333333333333333333333333333333333333333
3333333333333333333333333333333333333333333333333333333333333333
3333333333333333333333333333333333333333333333333333333333333333
3333333333333333333333333333333333333333333333333333333333333333