2222222222222222222222222222222222222222222222222222222222222222
2222222222222222222222222222222222222222222222222222222222222222
2222222222222222222222222222222222222222222222222222222222222222
2222222222222222222222222222222222222222222222222222222222222222
2222222222222222222222222222222222222222222222222222222222222222
2222222222222322232222222222222222222222222222222222222222222222
2222223222222522252222223222222222222222222222222222222222222222
2222222332222222222222332222222222222222222222222222222222222222
3333333332222222222222333333333333333333233333333333333333333333
333333333333333333333333333333333333333330000000000000000000000c
333330000000000000000000000000000000000000000000000000000000000c
a00000000000000000000000000000000000000000000000000000000000000c
a0000000000000000000000000000000000000000000000000000000000000pc
a000000000000000000000000000000000000000003333333333333333333333
a000000000000000000000000000000000000000333333333333333333333333
a000000003330000000000000000000000003333333333333333333333333333
ap00000000000000000000000000000000033333333333333333333333333333
3333333300000000333000333000333333333333333333333333333333333333
3333333330000000030000030000333333333333333333333223333333333333
3333333333000000030000030000333322233333333333333333333333333333
3333333333300000030000030000333333333333333333333333333333333333
3333222333330000030000030000333333333333333333333333333333333333
3333333333333000030000030000333333333333333333333333333333333333
33333333333333000000sl000000333333333333333333333333333333333333
3333333333333333333333333333333333333333333333333333333333333333