2222222222222222222222222222222222222222222222222222222222222
3333333333333333333333333333333333333333333333333333333333333
3333333333333333333333333333333333333333333333333333333333333
3333333333333333333333333333333333333333333333333333333333333
3333333333333333333333333333333333333333333333333333333333333
3333333333333333333333333333333333333333333333333333333333333
3333333333333333333333333333333333333333333333333333333333333
3ii0ii00000i000i000000000000000000000000000000000e000000
3000000000000000000000000000000000000000000000000e000000
3000000000000000000000000000000000000000000000000e000000
300000000000000000000000000000000000000000000000he500000
3000000000000000000000000000000000000033333333333333333333333
3000000000000000000000000000000000000033333333333333333333333
30n0000000000000000000000000000000000333333333333333333333333
3333333330000000000000000000000000000333333333333333333333333
3000000000000000000000000000000000003333333333333333333333333
bp000000000v005sssssss000000000000003333333333333333333333333
3333333333333333333333333333333333333333333333333333333333333
3333333333333333333333333333333333333333333333333333333333333
3333333333333333333333333333333333333333333333333333333333333
3333333333333333333333333333333333333333333333333333333333333
3333333333333333333333333333333333333333333333333333333333333
3333333333333333333333333333333333333333333333333333333333333
3333333333333333333333333333333333333333333333333333333333333
