2222222222222222222222222222222222222222222222222222222222222222
2222222222222222222222222223222222222222222222222222222222222223
2222222222222222222222222222333333333333333333333333333333333333
2222222222222222222222222233000000000000003333333333333333333333
2222222222222222222333333300000000000000000000333333333333333333
2222222222222222223000000000000000000000000000003333333333333333
2222222222222222330000000000000000000000000000000000333333333333
2222222222222233000000000000000000000000000000000000333333333333
2222222222223300000000000000000000000000000000000000000333333333
333333333333000000000000000000000000000000003000000000000000000d
b00000000000000000000000000000000000000000003000000000000000000d
b000000000000000000000000000000000000000000030000000000000000000
b0000000000000003000000000000000000000000000300000333330000000pd
bp0000000000000030000000000000000000000000l030000033333333333333
3333333000333000333300030030030003000333333330000033333333333333
3333333300000000330000000000000000000000000330000033333333333333
3333333330000000300000000000000000000000000030000333333333333333
3333333333000000000000000000000000000000000000000033333333333333
3333333333300000000000000000000000000000000000000033333333333333
3333333333300000000000000000000000000000000000003333333333333333
3333333333330000000000000000000000000000000000000033333333333333
3333333333333000000000000000000000000000000000000033333333333333
3333333333333300000000000000000000000000000000033333333333333333
3333333333333333300000000000000h00000000000003s33333333333333333
3333333333333333333333333333333333333333333333333333333333333333
