2222222222222222222222222222222222222222222222222222222222222222
2222222222222222222222222222222222222222222222222222222222222222
2222222222222222222222222222222222222222222222222222222222222222
2222222222222222222222222222222222222222222222222222222222222222
2222222222222222222222222222222222222222222222222222222222222222
2222222222222222222222222222222222222222222222222222222222222222
2222222222222322232222222222222222222222222222222222222222222222
2222222322222222222222332222222222222222222222222222222222222222
2222222222222222222222222222222222222222222222222222222222222222
2322222222222222222222222333333333335333333333333355553333333333
3333355555555333333333333333iii00000000000000000000000000000000b
eii000000000000000000000000000000000000000000000000000000000000b
000000000000000000000000000000000000000000000000000000000000000b
000000000000000000000p00000000000000000000000000000000000000000b
000000000000000000000000000000000000000000000000000000000000000b
00000000000000000000000000000000000555000000000000000000000000pb
p00000000000000t0vv000000000000003553555555555355555533333333333
3553555553553333555555555553333333333333333355555535555555555333
3333333333333333355555533333333333333333333333333333223333333333
3333333333355555555333332333333333322233333333333333333333333333
3333555555555553333333555533333333333333355555553333333333333333
3333222333333332233333223333333333333333333333333333333333333333
3333333333333332555555533333333333333333333333333333333333333333
3333333333333333333333333333333333333333333333333333333333333333
3333333333333333333333333333333333333333333333333333333333333333