4444444444444444444444444444444444444444444444444444444444444444
4000000000000000000000000000000000000000000000000000000000000004
4000000000000000000000000000000000000000000000000000000000000004
4800000000000000000000000000000000000000000000000000000000000004
4800000000000000000000000000000000000000000000000000000000000004
480h000000000000000000000000000000000000000000000000000000000004
4888888888000000000000000000000000000000000000000000000000000004
4000000000000000000000000000000000000000000000000000000000000004
4000000000000000000000000000000000000000000000000000000000000006
4000000000000008880000000000000000000000000000000000000000000006
4000000000000000000000000000000000000000000000000000000000000006
40n0000000000000000000000000000000000000000000000000000000000006
4888888880000000000000008888000000000000000000000000000000000006
400000000800000000000000000000007000000000000000000000l000000006
4000000000000000000000000000000070000000000888888888888888800004
4000000000000000000000000000000070000000000000800000000800000004
40000000008888000000000000000000777770000000008000000008000000s4
b000000000000000000000000000000070007000000000800000000800000064
bp00000000000000000000000000000070007s00000000800000000800000064
5555555555555555555555555555555555555555555555555555555555555554
3333333333333333333333333333333333333333333333333333333333333333
3333333333333333333333333333333333333333333333333333333333333333
3333333333333333333333333333333333333333333333333333333333333333
3333333333333333333333333333333333333333333333333333333333333333
3333333333333333333333333333333333333333333333333333333333333333